
 B B M M B B
 B B MMM B B
 B B M M B B
 B B     B B
BBBBBBBBBBBBB
BBBBBBBBBBBBB
     B B
 B B MBM B B
 B B B B B B
 B B     B B
 B B BBB B B
    PBFB